111111111111111111111111111111000111111
111111111111111111111111111111000111111
111111111111111111111111111111000111111
111111111111111111111111111111000111111
111111111111111111111111111111000111111
111111111111111111111111111111000111111
111111111111110000000000000001000111111
111111111111110000000000000001000111111
111111111111110000000000000001000111111
111111111111110001100000000001000111111
111111111111110001100000000001000111111
111111111111110001100000000001000111111
111111111111110000000000000001000111111
111111111111110000000000000001000111111
111111111111110000000000110001000111111
111111111111110000000000000001000111111
111111111111110000000000000001000111111
111111111111110000000000000001000111111
111111111111111111000011111111000111111
000000000000000000000000000000000000001
000000000000000000000000000000000000001
000000000000000000000000000000000000001
111111111111111111111111111111111100001
111111111111111111111111111111111100001
111111111111111111111111111111111100001
111111111111111111111111111111110000000
111111111111111111111111111111110000000
111111111111111111111111111111110000000
111111111111111111111111111111110000000
111111111111111111111111111111110000000
111111111111111111111111111111110000000
111111111111111111111111111111110000000
111111111111111111111111111111110000000
111111111111111111111111111111110000000
111111111111111111111111111111110000000
111111111111111111111111111111110000000
111111111111111111111111111111110000000
111111111111111111111111111111111111111
111111111111111111111111111111111111111
111111111111111111111111111111111111111